8,8,8,8,8,8,8,8,8,8,8,8,8,8,8,8,8,8,8,8,8,8,8,8,8,8,8,8,8,8,8,8,8,8,8,8,8,8,8,8,8,8,8,8,8,8,8,8,8,8,8,8,8,8,8,8,8,8,8,8,8,8,8,8,8,8,8,8,8,8,8,8,8,8,8,8,8,8,8,8,8,8,8,8,8,8,8,8,8,8,8,8,8,8,8,8,8,8,8,8
8,8,8,8,8,8,8,8,8,8,8,8,8,8,8,8,8,8,8,8,8,8,8,8,8,8,8,8,8,8,8,8,8,8,8,8,8,8,8,8,8,8,8,8,8,8,8,8,8,8,8,8,8,8,8,8,8,8,8,8,8,8,8,8,8,8,8,8,8,8,8,8,8,8,8,8,8,8,8,8,8,8,8,8,8,8,8,8,8,8,8,8,8,8,8,8,8,8,8,8
8,8,8,8,8,8,8,8,8,8,8,8,8,8,8,8,8,8,8,8,8,8,8,8,8,8,8,8,8,8,8,8,8,8,8,8,8,8,8,8,8,8,8,8,8,8,8,8,8,8,8,8,8,8,8,8,8,8,8,8,8,8,8,8,8,8,8,8,8,8,8,8,8,8,8,8,8,8,8,8,8,8,8,8,8,8,8,8,8,8,8,8,8,8,8,8,8,8,8,8
8,8,8,8,8,8,8,8,8,8,8,8,8,8,8,8,8,8,8,8,8,8,8,8,8,8,8,8,8,8,8,8,8,8,8,8,8,8,8,8,8,8,8,8,8,8,8,8,8,8,8,8,8,8,8,8,8,8,8,8,8,8,8,8,8,8,8,8,8,8,8,8,8,8,8,8,8,8,8,8,8,8,8,8,8,8,8,8,8,8,8,8,8,8,8,8,8,8,8,8
8,8,8,8,8,8,8,8,8,8,8,8,8,8,25,5,5,5,5,4,4,4,5,4,5,4,4,5,4,5,5,4,4,5,5,5,4,4,4,4,4,5,4,5,5,5,4,4,5,4,4,5,4,5,4,5,4,5,5,4,5,5,4,5,4,4,5,4,5,5,4,5,4,4,5,5,4,4,5,5,5,4,4,4,5,5,4,4,4,22,8,8,8,8,8,8,8,8,8,8
8,8,8,8,8,8,8,8,8,8,8,8,8,8,14,3,6,6,6,6,7,7,7,6,6,6,7,7,6,7,6,7,6,7,6,7,7,7,7,6,7,6,6,7,6,7,6,6,7,7,7,6,7,7,6,6,7,7,6,6,6,6,7,6,7,6,7,7,6,7,6,6,6,6,6,7,6,6,7,6,7,7,6,6,6,6,7,7,3,10,8,8,8,8,8,8,8,8,8,8
8,8,8,8,8,8,8,8,8,8,8,8,8,8,14,21,2,19,18,19,19,18,18,19,19,19,19,19,19,19,19,19,19,19,18,19,18,19,19,19,19,18,18,18,18,19,18,19,19,18,19,19,19,18,18,18,19,19,19,18,18,18,18,18,19,19,19,18,18,19,19,18,18,18,18,18,19,19,19,18,19,18,19,19,18,19,19,2,16,11,8,8,8,8,8,8,8,8,8,8
8,8,8,8,8,8,8,8,8,8,8,8,8,8,15,20,17,29,12,12,13,13,12,13,12,13,12,12,12,12,12,12,13,12,12,13,12,12,13,12,12,13,13,12,13,12,13,13,12,13,12,12,13,13,13,13,13,13,12,12,12,12,13,13,13,13,13,12,12,13,13,13,13,12,12,12,12,13,13,12,12,13,13,12,12,12,27,20,16,10,8,8,8,8,8,8,8,8,8,8
8,8,8,8,8,8,8,8,8,8,8,8,8,8,14,21,17,11,2,2,3,3,2,3,3,2,3,2,2,2,3,2,2,2,3,2,2,2,3,3,3,2,3,2,2,2,3,2,3,3,3,3,2,3,2,3,2,2,3,3,3,2,2,3,2,3,2,3,3,2,2,2,2,2,2,2,3,3,2,3,3,2,2,3,2,2,14,20,16,11,8,8,8,8,8,8,8,8,8,8
8,8,8,8,8,8,8,8,8,8,8,8,8,8,15,21,17,10,3,0,1,0,0,0,1,0,1,1,0,0,0,1,0,0,0,1,0,1,1,0,1,0,0,1,0,0,0,0,0,1,0,0,1,0,1,1,0,0,1,0,1,0,1,0,0,0,1,0,1,1,1,0,0,0,1,0,0,1,1,1,1,1,1,0,1,2,14,21,16,11,8,8,8,8,8,8,8,8,8,8
4,4,5,5,4,5,5,5,5,5,5,4,4,5,28,21,17,10,2,0,0,0,1,1,0,1,1,0,1,1,0,1,1,1,0,0,1,1,0,0,0,0,0,1,0,1,0,1,1,0,0,0,1,1,0,1,0,0,1,0,1,0,0,1,0,1,1,1,1,0,0,0,0,0,1,0,0,0,0,1,1,0,1,0,0,3,15,20,16,11,8,8,8,8,8,8,8,8,8,8
13,13,13,12,13,12,12,13,12,13,12,13,12,12,12,12,13,23,2,1,1,1,1,0,1,0,1,0,1,1,1,0,1,1,1,1,0,1,0,0,1,0,0,0,1,1,1,0,1,0,0,1,1,1,1,1,1,0,1,1,0,1,0,0,1,0,1,1,0,0,1,1,1,1,0,0,1,1,0,0,1,1,0,1,0,2,14,20,16,10,8,8,8,8,8,8,8,8,8,8
2,3,2,3,2,3,2,3,2,3,2,3,2,3,2,3,3,3,2,0,0,1,0,0,1,1,1,0,0,0,0,0,0,1,0,0,0,1,1,0,1,1,0,1,0,0,0,1,1,0,1,0,0,0,1,0,0,0,1,1,1,1,1,1,0,0,0,0,1,1,0,0,0,0,1,1,1,0,1,1,1,1,0,0,1,2,14,21,16,11,8,8,8,8,8,8,8,8,8,8
1,0,0,1,1,0,1,0,1,0,1,0,0,1,1,0,1,0,1,0,1,0,1,1,0,0,1,0,0,0,0,0,1,1,1,0,0,0,1,1,1,0,0,0,0,1,1,1,1,0,0,0,0,0,0,1,0,0,1,0,1,0,0,1,1,1,0,0,0,0,0,1,0,0,1,0,1,0,0,1,0,0,0,0,0,3,15,20,17,11,8,8,8,8,8,8,8,8,8,8
0,0,0,1,0,1,0,0,1,0,1,0,0,0,0,0,1,0,1,1,0,1,1,0,1,0,0,0,0,0,1,1,0,1,0,0,1,1,0,1,0,1,0,1,0,1,0,1,1,0,0,1,0,1,0,1,1,0,1,1,1,0,0,1,0,1,0,1,0,0,0,0,0,0,1,1,1,1,0,1,1,1,1,1,1,2,15,21,17,11,8,8,8,8,8,8,8,8,8,8
2,3,2,3,2,3,2,3,2,3,2,3,2,3,2,3,3,2,3,0,0,0,0,0,1,1,1,0,1,0,0,1,1,0,1,1,0,1,0,1,1,0,0,0,1,0,0,0,0,0,1,1,0,0,1,0,1,1,0,1,0,0,0,1,0,1,1,0,1,1,0,1,0,1,1,1,0,1,0,1,1,0,0,0,1,2,14,21,17,11,8,8,8,8,8,8,8,8,8,8
5,5,5,4,4,5,5,4,5,5,4,5,4,4,4,4,5,22,2,0,1,0,1,0,0,0,0,1,0,1,1,1,1,1,1,0,0,0,1,1,0,0,0,1,0,1,0,1,1,0,1,1,1,0,0,1,1,0,0,0,1,1,1,0,0,0,0,1,0,0,1,1,1,1,1,1,1,0,0,1,1,0,0,0,0,2,14,21,17,11,8,8,8,8,8,8,8,8,8,8
13,12,13,13,12,13,12,13,13,13,12,12,13,13,27,20,17,11,3,1,0,1,1,1,1,1,1,1,0,0,0,0,1,0,0,1,0,0,0,0,0,1,1,1,0,1,0,0,0,0,1,1,1,1,1,0,1,0,1,1,0,0,0,1,0,0,1,0,1,0,0,0,0,1,1,1,0,1,1,0,0,0,0,0,0,2,14,20,17,10,8,8,8,8,8,8,8,8,8,8
8,8,8,8,8,8,8,8,8,8,8,8,8,8,14,21,17,10,2,0,1,0,0,1,1,0,0,1,0,0,0,0,1,1,0,1,0,1,1,0,1,0,0,0,1,0,1,1,1,0,1,1,0,1,1,0,1,0,0,0,1,0,0,0,1,0,0,1,1,0,1,1,0,1,1,1,0,0,1,0,1,0,1,1,1,2,14,20,17,10,8,8,8,8,8,8,8,8,8,8
8,8,8,8,8,8,8,8,8,8,8,8,8,8,15,21,17,11,3,2,2,3,3,2,3,2,3,2,2,3,2,2,3,3,3,3,2,3,3,3,2,3,3,2,2,3,3,2,3,3,2,2,3,3,2,3,3,3,3,2,2,3,3,3,2,2,2,2,2,2,3,3,2,1,0,0,0,0,1,1,1,1,0,1,1,2,15,20,17,11,8,8,8,8,8,8,8,8,8,8
8,8,8,8,8,8,8,8,8,8,8,8,8,8,14,21,17,26,5,4,4,5,4,5,4,5,4,5,5,5,4,5,4,4,4,5,4,4,4,5,4,5,5,5,4,4,5,4,5,4,5,5,4,4,5,4,4,5,5,5,4,4,5,4,4,4,4,4,4,4,5,22,3,1,1,0,0,0,1,0,0,1,0,0,1,2,14,20,16,10,8,8,8,8,8,8,8,8,8,8
8,8,8,8,8,8,8,8,8,8,8,8,8,8,15,20,3,7,6,7,7,7,7,6,7,7,7,7,6,6,7,6,6,6,6,7,6,6,7,7,6,7,6,6,7,6,7,7,6,6,6,6,7,7,7,7,6,7,6,7,6,7,6,7,7,7,7,7,7,7,3,10,2,1,1,0,1,1,1,1,0,0,0,1,1,2,14,20,17,11,8,8,8,8,8,8,8,8,8,8
8,8,8,8,8,8,8,8,8,8,8,8,8,8,14,3,18,18,18,19,19,18,19,18,18,19,18,18,19,19,19,18,18,19,19,19,19,18,18,18,19,18,18,19,19,19,18,19,19,19,19,19,19,18,18,19,19,18,18,19,18,18,18,18,18,19,18,18,19,3,17,10,3,1,0,1,0,0,1,0,1,1,0,0,0,2,14,20,17,10,8,8,8,8,8,8,8,8,8,8
8,8,8,8,8,8,8,8,8,8,8,8,8,8,24,12,13,12,12,13,13,12,13,12,13,12,12,13,13,13,12,12,12,12,13,12,13,12,12,13,13,12,13,12,12,13,12,13,13,13,13,13,12,13,13,12,12,12,13,13,13,12,13,13,12,12,13,13,27,20,16,11,3,0,1,1,0,1,1,1,0,0,0,0,0,2,14,21,16,11,8,8,8,8,8,8,8,8,8,8
8,8,8,8,8,8,8,8,8,8,8,8,8,8,8,8,8,8,8,8,8,8,8,8,8,8,8,8,8,8,8,8,8,8,8,8,8,8,8,8,8,8,8,8,8,8,8,8,8,8,8,8,8,8,8,8,8,8,8,8,8,8,8,8,8,8,8,8,15,21,17,11,3,1,1,1,1,0,1,1,0,0,0,0,0,3,14,21,17,11,8,8,8,8,8,8,8,8,8,8
8,8,8,8,8,8,8,8,8,8,8,8,8,8,8,8,8,8,8,8,8,8,8,8,8,8,8,8,8,8,8,8,8,8,8,8,8,8,8,8,8,8,8,8,8,8,8,8,8,8,8,8,8,8,8,8,8,8,8,8,8,8,8,8,8,8,8,8,14,21,16,10,3,0,1,0,1,0,1,1,0,0,1,1,0,2,14,21,17,11,8,8,8,8,8,8,8,8,8,8
8,8,8,8,8,8,8,8,8,8,8,8,8,8,8,8,8,8,8,8,8,8,8,8,8,8,8,8,8,8,8,8,8,8,8,8,8,8,8,8,8,8,8,8,8,8,8,8,8,8,8,8,8,8,8,8,8,8,8,8,8,8,8,8,8,8,8,8,14,21,16,11,3,0,0,0,0,0,1,0,0,0,1,0,0,3,15,20,17,11,8,8,8,8,8,8,8,8,8,8
8,8,8,8,8,8,8,8,8,8,8,8,8,8,8,8,8,8,8,8,8,8,8,8,8,8,8,8,8,8,8,8,8,8,8,8,8,8,8,8,8,8,8,8,8,8,8,8,8,8,8,8,8,8,8,8,8,8,8,8,8,8,8,8,8,8,8,8,15,21,17,10,2,1,0,0,0,1,0,0,1,1,1,0,0,2,14,20,16,11,8,8,8,8,8,8,8,8,8,8
8,8,8,8,8,8,8,8,8,8,8,8,8,8,8,8,8,8,8,8,8,8,8,8,8,8,8,8,8,8,8,8,8,8,8,8,8,8,8,8,8,8,8,8,8,8,8,8,8,8,8,8,8,8,8,8,8,8,8,8,8,8,8,8,8,8,8,8,14,21,16,10,3,0,0,1,1,1,1,1,0,0,1,0,0,2,15,20,17,11,8,8,8,8,8,8,8,8,8,8
8,8,8,8,8,8,8,8,8,8,8,8,8,8,8,8,8,8,8,8,8,8,8,8,8,8,8,8,8,8,8,8,8,8,8,8,8,8,8,8,8,8,8,8,8,8,8,8,8,8,8,8,8,8,8,8,8,8,8,8,8,8,8,8,8,8,8,8,15,20,16,10,3,0,1,0,1,1,0,1,0,0,1,0,1,2,14,20,17,11,8,8,8,8,8,8,8,8,8,8
8,8,8,8,8,8,8,8,8,8,8,8,8,8,8,8,8,8,8,8,8,8,8,8,8,8,8,8,8,8,8,8,8,8,8,8,8,8,8,8,8,8,8,8,8,8,8,8,8,8,8,8,8,8,8,8,8,8,8,8,8,8,8,8,8,8,8,8,15,21,17,10,2,3,3,3,3,2,2,2,3,0,1,3,3,3,14,21,16,11,8,8,8,8,8,8,8,8,8,8
8,8,8,8,8,8,8,8,8,8,8,8,8,8,8,8,8,8,8,8,8,8,8,8,8,8,8,8,8,8,8,8,8,8,8,8,8,8,8,8,8,8,8,8,8,8,8,8,8,8,8,8,8,8,8,8,8,8,8,8,8,8,8,8,8,8,8,8,14,20,16,26,5,5,5,4,4,4,5,22,2,1,1,3,25,4,28,20,16,10,8,8,8,8,8,8,8,8,8,8
8,8,8,8,8,8,8,8,8,8,8,8,8,8,8,8,8,8,8,8,8,8,8,8,8,8,8,8,8,8,8,8,8,8,8,8,8,8,8,8,8,8,8,8,8,8,8,8,8,8,8,8,8,8,8,8,8,8,8,8,8,8,8,8,8,8,8,8,15,21,2,6,7,7,7,6,7,6,6,11,3,1,1,2,14,6,6,3,16,11,8,8,8,8,8,8,8,8,8,8
8,8,8,8,8,8,8,8,8,8,8,8,8,8,8,8,8,8,8,8,8,8,8,8,8,8,8,8,8,8,8,8,8,8,8,8,8,8,8,8,8,8,8,8,8,8,8,8,8,8,8,8,8,8,8,8,8,8,8,8,8,8,8,8,8,8,8,8,15,3,19,19,19,18,18,19,18,18,18,11,2,1,1,2,14,18,18,18,3,10,8,8,8,8,8,8,8,8,8,8
8,8,8,8,8,8,8,8,8,8,8,8,8,8,8,8,8,8,8,8,8,8,8,8,8,8,8,8,8,8,8,8,8,8,8,8,8,8,8,8,8,8,8,8,8,8,8,8,8,8,8,8,8,8,8,8,8,8,8,8,8,8,8,8,8,8,8,8,24,12,13,12,12,12,13,12,13,13,27,10,3,0,1,3,15,29,13,12,12,23,8,8,8,8,8,8,8,8,8,8
8,8,8,8,8,8,8,8,8,8,8,8,8,8,8,8,8,8,8,8,8,8,8,8,8,8,8,8,8,8,8,8,8,8,8,8,8,8,8,8,8,8,8,8,8,8,8,8,8,8,8,8,8,8,8,8,8,8,8,8,8,8,8,8,8,8,8,8,8,8,8,8,8,8,8,8,8,8,14,10,2,1,0,2,15,10,8,8,8,8,8,8,8,8,8,8,8,8,8,8
8,8,8,8,8,8,8,8,8,8,8,8,8,8,8,8,8,8,8,8,8,8,8,8,8,8,8,8,8,8,8,8,8,8,8,8,8,8,8,8,8,8,8,8,8,8,8,8,8,8,8,8,8,8,8,8,8,8,8,8,8,8,8,8,8,8,8,8,8,8,8,8,8,8,8,8,8,8,14,10,3,0,1,2,14,10,8,8,8,8,8,8,8,8,8,8,8,8,8,8
8,8,8,8,8,8,8,8,8,8,8,8,8,8,8,8,8,8,8,8,8,8,8,8,8,8,8,8,8,8,8,8,8,8,8,8,8,8,8,8,8,8,8,8,8,8,8,8,8,8,8,8,8,8,8,8,8,8,8,8,8,8,8,8,8,8,8,8,8,8,8,8,8,8,8,8,8,8,14,10,3,1,0,3,14,11,8,8,8,8,8,8,8,8,8,8,8,8,8,8
8,8,8,8,8,8,8,8,8,8,8,8,8,8,8,8,8,8,8,8,8,8,8,8,8,8,8,8,8,8,8,8,8,8,8,8,8,8,8,8,8,8,8,8,8,8,8,8,8,8,8,8,8,8,8,8,8,8,8,8,8,8,8,8,8,8,8,8,8,8,8,8,8,8,8,8,8,8,15,11,2,0,0,2,14,11,8,8,8,8,8,8,8,8,8,8,8,8,8,8
8,8,8,8,8,8,8,8,8,8,8,8,8,8,8,8,8,8,8,8,8,8,8,8,8,8,8,8,8,8,8,8,8,8,8,8,8,8,8,8,8,8,8,8,8,8,8,8,8,8,8,8,8,8,8,8,8,8,8,8,8,8,8,8,8,8,8,8,8,8,8,8,8,8,8,8,8,8,14,10,3,1,0,2,15,11,8,8,8,8,8,8,8,8,8,8,8,8,8,8
