9,9,8,9,9,8,9,9,9,9,8,9,8,8,9,9,8,8,8,8,9,9,8,8,9,9,9,8,9,8,8,8,9,8,8,9,8,8,8,8,8,8,8,8,8,9,8,9,9,8,9,9,9,8,8,8,8,8,8,9,9,8,9,9,8,9,8,8,8,9,9,8,8,8,9,9,8,9,14,21,17,11,2,1,0,2,14,20,17,10,9,9,8,9,9,8,8,9,8,9
9,8,8,8,8,8,9,8,9,8,9,9,9,9,9,9,9,9,9,8,8,8,8,8,9,9,8,8,8,8,8,9,9,8,8,9,9,8,8,9,9,9,8,8,9,9,9,9,8,8,9,9,9,9,9,8,8,8,9,8,9,9,8,9,8,8,9,9,9,9,8,8,8,9,8,9,8,8,14,21,17,11,2,1,0,2,14,20,17,10,9,8,9,8,9,9,9,8,9,9
9,9,8,8,9,8,9,9,8,9,9,8,8,8,9,9,9,8,9,8,8,8,9,8,9,8,9,9,8,9,8,8,8,8,8,8,8,8,8,9,9,8,8,8,9,8,9,9,8,8,8,8,8,8,9,9,8,9,9,9,8,9,8,8,8,8,9,9,8,9,8,9,8,8,8,8,8,8,14,20,16,10,2,1,0,2,14,20,17,10,9,8,9,9,9,9,8,8,8,9
9,8,9,9,9,9,8,8,9,9,9,9,9,9,9,8,8,8,8,9,8,9,9,9,8,9,9,9,8,8,8,8,9,9,8,9,9,9,9,9,9,8,9,9,8,8,9,8,9,9,8,8,8,9,9,8,9,9,9,9,9,8,9,8,9,8,8,9,8,8,9,9,9,9,9,8,9,9,15,20,17,10,2,1,0,2,15,20,16,11,8,9,9,8,8,9,9,9,8,8
8,9,9,8,9,9,9,9,8,9,9,8,8,8,9,9,9,8,9,8,9,9,8,8,8,9,9,9,9,9,9,8,8,8,9,9,8,8,8,8,9,8,9,8,9,8,9,9,9,9,9,8,8,8,8,8,8,8,9,8,8,8,9,8,8,9,8,8,9,9,8,9,8,8,8,8,9,9,14,21,16,10,2,1,0,2,14,20,16,10,9,9,8,9,8,8,8,8,9,9
8,9,9,8,8,8,8,9,9,9,8,9,9,9,8,9,8,9,9,8,8,8,8,9,8,8,8,9,8,9,8,8,9,9,9,8,9,8,8,8,8,8,8,9,8,9,8,8,9,9,8,8,8,8,8,8,9,8,9,9,8,9,8,9,8,8,9,9,9,8,9,8,8,9,9,9,8,8,15,21,17,10,2,1,0,2,15,20,16,11,8,8,9,9,9,8,8,8,9,9
8,8,8,8,9,8,8,9,8,9,8,9,8,9,8,8,9,9,9,8,9,9,8,8,9,9,9,9,9,9,9,9,9,9,8,8,9,9,9,8,8,8,8,9,9,8,8,9,8,9,9,9,8,8,8,9,8,8,9,8,9,8,8,8,8,8,8,9,9,9,9,9,9,9,8,8,8,8,15,21,17,10,2,1,0,2,15,20,17,10,9,9,8,8,9,9,8,9,9,9
8,9,9,9,9,8,9,8,9,8,9,8,8,8,8,9,8,9,9,9,8,9,8,8,8,9,8,9,8,8,8,9,8,8,8,9,8,9,8,9,8,9,8,9,8,9,9,9,9,8,8,9,9,9,8,9,9,9,8,9,8,8,8,9,9,8,9,8,9,9,9,9,9,9,9,9,9,8,14,20,17,10,2,1,0,2,15,21,17,11,9,8,9,8,9,9,8,9,9,9
8,9,9,9,9,25,5,4,5,4,4,5,5,4,4,4,5,4,4,4,4,4,5,5,4,5,5,4,4,5,5,5,4,4,5,4,4,5,5,5,5,4,4,5,4,4,5,5,5,4,4,5,4,5,5,4,4,5,22,9,9,9,9,8,9,8,9,25,4,5,5,4,4,5,5,5,5,4,28,21,16,11,2,1,0,2,15,20,16,26,5,5,4,4,4,5,4,4,5,8
9,8,8,8,8,15,3,6,7,7,6,7,6,6,6,6,6,6,7,6,7,7,7,7,6,6,7,7,6,7,6,6,7,7,7,6,7,6,6,7,7,7,7,7,7,6,7,7,6,6,7,7,7,6,7,6,7,2,10,9,9,8,9,9,8,9,9,14,3,6,6,6,7,6,6,6,7,6,7,3,17,11,2,1,0,2,14,21,3,6,7,7,7,6,6,7,6,7,7,8
9,8,8,9,9,15,20,3,18,18,18,19,19,19,18,18,19,19,19,18,18,19,18,18,19,18,19,18,19,19,18,18,19,18,19,19,18,19,18,18,18,18,19,19,19,18,18,19,19,19,18,19,18,19,18,19,3,16,11,8,9,8,8,9,8,8,9,15,21,2,19,18,18,18,18,19,18,18,18,19,2,11,2,1,0,2,15,2,19,18,19,19,18,19,19,19,18,18,19,8
8,9,8,9,9,15,20,17,29,13,13,13,12,12,13,13,13,13,12,13,12,12,13,13,12,13,13,13,13,12,13,12,12,12,12,12,12,13,12,12,12,13,12,12,12,13,13,12,12,12,13,12,12,12,13,27,20,16,11,8,9,8,9,8,8,9,9,15,21,16,29,12,12,13,12,12,13,13,13,12,13,23,2,1,0,2,24,13,13,12,13,13,13,12,13,12,12,13,27,8
8,8,8,8,9,15,20,16,10,2,2,3,2,3,2,3,2,3,2,3,2,3,2,3,2,3,2,3,2,3,2,3,2,3,2,3,2,3,2,3,2,3,2,3,2,3,2,3,2,3,2,3,2,3,2,14,21,17,10,9,8,8,9,8,9,8,8,15,21,16,10,2,2,2,2,2,2,2,2,2,2,2,2,1,0,2,2,2,2,2,2,2,2,2,2,2,2,2,14,8
8,9,8,8,9,14,21,16,10,2,0,1,0,1,0,1,0,1,0,1,0,1,0,1,0,1,0,1,0,1,0,1,0,1,0,1,0,1,0,1,0,1,0,1,0,1,0,1,0,1,0,1,0,1,2,14,20,16,11,8,9,8,8,8,8,8,9,15,20,17,11,2,0,1,0,1,0,1,0,1,0,1,0,1,0,1,0,1,0,1,0,1,0,1,0,1,0,2,14,8
8,9,9,8,8,15,20,16,11,2,0,1,0,1,0,1,0,1,0,1,0,1,0,1,0,1,0,1,0,1,0,1,0,1,0,1,0,1,0,1,0,1,0,1,0,1,0,1,0,1,0,1,0,1,2,14,20,17,11,9,9,8,8,9,9,9,8,15,20,17,10,2,0,1,0,1,0,1,0,1,0,1,0,1,0,1,0,1,0,1,0,1,0,1,0,1,0,2,15,8
8,9,8,8,9,15,20,17,10,2,0,1,0,1,0,1,0,1,0,1,0,1,0,1,0,1,0,1,0,1,0,1,0,1,0,1,0,1,0,1,0,1,0,1,0,1,0,1,0,1,0,1,0,1,2,14,21,16,11,9,9,9,8,8,8,9,9,15,21,17,10,2,0,1,0,1,0,1,0,1,0,1,0,1,0,1,0,1,0,1,0,1,0,1,0,1,0,2,14,8
9,9,9,8,9,14,20,16,11,2,0,1,0,1,0,1,0,1,0,1,0,1,0,1,0,1,0,1,0,1,0,1,0,1,0,1,0,1,0,1,0,1,0,1,0,1,0,1,0,1,0,1,0,1,2,15,21,17,10,9,8,9,9,9,9,9,8,15,21,16,11,2,0,1,0,1,0,1,0,1,0,1,0,1,0,1,0,1,0,1,0,1,0,1,0,1,0,2,14,8
9,8,9,8,8,14,21,17,11,2,0,1,0,1,0,1,0,1,0,1,0,1,0,1,0,1,0,1,0,1,0,1,0,1,0,1,0,1,0,1,0,1,0,1,0,1,0,1,0,1,0,1,0,1,2,14,20,17,10,9,9,8,9,8,9,8,8,15,21,16,11,2,0,1,0,1,0,1,0,1,0,1,0,1,0,1,0,1,0,1,0,1,0,1,0,1,0,2,14,8
9,9,8,9,8,14,20,16,10,2,0,1,0,1,0,1,0,1,0,1,0,1,0,1,0,1,0,1,0,1,0,1,0,1,0,1,0,1,0,1,0,1,0,1,0,1,0,1,0,1,0,1,0,1,2,14,21,16,11,9,9,8,8,8,8,8,9,15,21,16,10,2,0,1,0,1,0,1,0,1,0,1,0,1,0,1,0,1,0,1,0,1,0,1,0,1,0,2,14,8
8,9,8,8,9,14,20,17,10,2,0,1,0,1,0,1,0,1,0,1,0,1,0,1,0,1,0,1,0,1,0,1,0,1,0,1,0,1,0,1,0,1,0,1,0,1,0,1,0,1,0,1,0,1,2,14,20,16,10,8,9,8,8,9,9,9,8,14,20,16,10,2,0,1,0,1,0,1,0,1,0,1,0,1,0,1,0,1,0,1,0,1,0,1,0,1,0,2,15,8
9,9,8,9,9,14,21,17,11,2,0,1,0,1,0,1,0,1,0,1,0,1,0,1,0,1,0,1,0,1,0,1,0,1,0,1,0,1,0,1,0,1,0,1,0,1,0,1,0,1,0,1,0,1,2,14,21,16,26,4,4,4,5,5,4,5,4,28,20,17,10,2,0,1,0,1,0,1,0,1,0,1,0,1,0,1,0,1,0,1,0,1,0,1,0,1,0,2,15,8
8,8,9,9,8,15,20,16,10,2,0,1,0,1,0,1,0,1,0,1,0,1,0,1,0,1,0,1,0,1,0,1,0,1,0,1,0,1,0,1,0,1,0,1,0,1,0,1,0,1,0,1,0,1,2,15,21,2,6,6,7,7,7,7,6,7,6,7,3,17,11,2,0,1,0,1,0,1,0,1,0,1,0,1,0,1,0,1,0,1,0,1,0,1,0,1,0,2,14,8
8,9,9,9,9,14,21,17,10,2,0,1,0,1,0,1,0,1,0,1,0,1,0,1,0,1,0,1,0,1,0,1,0,1,0,1,0,1,0,1,0,1,0,1,0,1,0,1,0,1,0,1,0,1,2,14,3,18,18,19,18,19,18,19,19,18,18,19,18,3,10,2,0,1,0,1,0,1,0,1,0,1,0,1,0,1,0,1,0,1,0,1,0,1,0,1,0,2,15,8
5,4,4,5,4,28,20,17,10,2,0,1,0,1,0,1,0,1,0,1,0,1,0,1,0,1,0,1,0,1,0,1,0,1,0,1,0,1,0,1,0,1,0,1,0,1,0,1,0,1,0,1,0,1,2,24,13,12,12,13,13,12,13,13,12,12,13,13,12,13,23,2,0,1,0,1,0,1,0,1,0,1,0,1,0,1,0,1,0,1,0,1,0,1,0,1,0,2,14,8
7,6,6,6,6,7,3,17,11,2,0,1,0,1,0,1,0,1,0,1,0,1,0,1,0,1,0,1,0,1,0,1,0,1,0,1,0,1,0,1,0,1,0,1,0,1,0,1,0,1,0,1,0,1,2,2,3,2,3,2,3,2,3,2,3,2,3,2,3,2,3,2,0,1,0,1,0,1,0,1,0,1,0,1,0,1,0,1,0,1,0,1,0,1,0,1,0,2,14,8
18,19,19,19,18,18,19,3,11,2,0,1,0,1,0,1,0,1,0,1,0,1,0,1,0,1,0,1,0,1,0,1,0,1,0,1,0,1,0,1,0,1,0,1,0,1,0,1,0,1,0,1,0,1,0,1,0,1,0,1,0,1,0,1,0,1,0,1,0,1,0,1,0,1,0,1,0,1,0,1,0,1,0,1,0,1,0,1,0,1,0,1,0,1,0,1,0,2,15,8
12,12,12,13,13,12,13,12,23,2,0,1,0,1,0,1,0,1,0,1,0,1,0,1,0,1,0,1,0,1,0,1,0,1,0,1,0,1,0,1,0,1,0,1,0,1,0,1,0,1,0,1,0,1,0,1,0,1,0,1,0,1,0,1,0,1,0,1,0,1,0,1,0,1,0,1,0,1,0,1,0,1,0,1,0,1,0,1,0,1,0,1,0,1,0,1,0,2,14,8
2,3,2,3,2,3,2,3,2,3,0,1,0,1,0,1,0,1,0,1,0,1,0,1,0,1,0,1,0,1,0,1,0,1,0,1,0,1,0,1,0,1,0,1,0,1,0,1,0,1,0,1,0,1,0,1,0,1,0,1,0,1,0,1,0,1,0,1,0,1,0,1,0,1,0,1,0,1,0,1,0,1,0,1,0,1,0,1,0,1,0,1,0,1,0,1,0,2,14,8
0,1,0,1,0,1,0,1,0,1,0,1,0,1,0,1,0,1,0,1,0,1,0,1,0,1,0,1,0,1,0,1,0,1,0,1,0,1,0,1,0,1,0,1,0,1,0,1,0,1,0,1,0,1,0,1,0,1,0,1,0,1,0,1,0,1,0,1,0,1,0,1,0,1,0,1,0,1,0,1,0,1,0,1,0,1,0,1,0,1,0,1,0,1,0,1,0,2,15,8
0,1,0,1,0,1,0,1,0,1,0,1,0,1,0,1,0,1,0,1,0,1,0,1,0,1,0,1,0,1,0,1,0,1,0,1,0,1,0,1,0,1,0,1,0,1,0,1,0,1,0,1,0,1,0,1,0,1,0,1,0,1,0,1,0,1,0,1,0,1,0,1,0,1,0,1,0,1,0,1,0,1,0,1,0,1,0,1,0,1,0,1,0,1,0,1,0,2,15,8
2,3,2,3,2,3,2,3,2,3,0,1,0,1,0,1,0,1,0,1,0,1,0,1,0,1,0,1,0,1,0,1,0,1,0,1,0,1,0,1,0,1,0,1,0,1,0,1,0,1,0,1,0,1,0,1,0,1,0,1,0,1,0,1,0,1,0,1,0,1,0,1,0,1,0,1,0,1,0,1,0,1,0,1,0,1,0,1,0,1,0,1,0,1,0,1,0,2,14,8
4,5,4,5,4,4,4,5,22,2,0,1,0,1,0,1,0,1,0,1,0,1,0,1,0,1,0,1,0,1,0,1,0,1,0,1,0,1,0,1,0,1,0,1,0,1,0,1,0,1,0,1,0,1,0,1,0,1,0,1,0,1,0,1,0,1,0,1,0,1,0,1,0,1,0,1,0,1,0,1,0,1,0,1,0,1,0,1,0,1,0,1,0,1,0,1,0,2,15,8
7,6,6,6,6,6,7,3,10,2,0,1,0,1,0,1,0,1,0,1,0,1,0,1,0,1,0,1,0,1,0,1,0,1,0,1,0,1,0,1,0,1,0,1,0,1,0,1,0,1,0,1,0,1,0,1,0,1,0,1,0,1,0,1,0,1,0,1,0,1,0,1,0,1,0,1,0,1,0,1,0,1,0,1,0,1,0,1,0,1,0,1,0,1,0,1,0,2,15,8
18,19,19,19,19,19,2,16,11,2,0,1,0,1,0,1,0,1,0,1,0,1,0,1,0,1,0,1,0,1,0,1,0,1,0,1,0,1,0,1,0,1,0,1,0,1,0,1,0,1,0,1,0,1,0,1,0,1,0,1,0,1,0,1,0,1,0,1,0,1,0,1,0,1,0,1,0,1,0,1,0,1,0,1,0,1,0,1,0,1,0,1,0,1,0,1,0,2,14,8
13,12,13,13,12,27,21,16,10,2,0,1,0,1,0,1,0,1,0,1,0,1,0,1,0,1,0,1,0,1,0,1,0,1,0,1,0,1,0,1,0,1,0,1,0,1,0,1,0,1,0,1,0,1,0,1,0,1,0,1,0,1,0,1,0,1,0,1,0,1,0,1,0,1,0,1,0,1,0,1,0,1,0,1,0,1,0,1,0,1,0,1,0,1,0,1,0,2,15,8
8,8,8,8,9,15,20,16,11,2,0,1,0,1,0,1,0,1,0,1,0,1,0,1,0,1,0,1,0,1,0,1,0,1,0,1,0,1,0,1,0,1,0,1,0,1,0,1,0,1,0,1,0,1,0,1,0,1,0,1,0,1,0,1,0,1,0,1,0,1,0,1,0,1,0,1,0,1,0,1,0,1,0,1,0,1,0,1,0,1,0,1,0,1,0,1,0,2,14,8
8,8,8,8,9,14,21,17,11,2,2,3,2,3,2,3,2,3,2,3,2,3,2,3,2,3,2,3,2,3,2,3,2,3,2,3,2,3,2,3,2,3,2,3,2,3,2,3,2,3,2,3,2,3,2,3,2,3,2,3,2,3,2,3,2,3,2,3,2,3,2,3,2,3,2,3,2,3,2,3,2,3,2,3,2,3,2,3,2,3,2,3,2,3,2,3,2,2,15,8
9,9,9,8,9,15,21,16,26,4,5,4,5,4,5,4,4,5,4,4,4,5,4,5,5,5,4,5,5,5,4,5,4,5,5,5,5,5,5,4,4,4,5,5,5,5,4,5,4,4,4,4,5,5,4,5,5,4,4,5,5,5,5,4,5,5,4,4,4,4,4,5,5,5,4,5,5,5,4,5,5,4,4,4,5,5,5,4,5,5,5,5,4,4,4,4,5,5,28,8
9,8,8,8,9,15,21,2,7,6,7,6,6,6,7,7,6,6,6,7,6,7,6,6,7,6,6,6,7,6,7,6,6,6,6,7,6,6,6,6,7,6,7,6,7,7,7,7,6,6,7,6,7,7,6,7,7,7,6,6,7,7,6,7,7,6,7,7,6,6,6,6,7,7,6,6,6,7,6,6,6,6,7,6,7,6,7,7,7,6,7,7,7,6,7,6,6,6,7,8
9,8,8,9,8,15,3,18,19,19,18,19,18,19,18,19,19,19,19,18,18,19,19,19,19,19,18,18,18,18,18,18,19,18,18,19,19,19,18,19,18,19,18,18,19,19,19,18,18,18,19,18,19,18,18,18,19,19,18,19,19,19,19,18,18,19,18,18,19,19,19,18,19,18,19,19,19,18,19,19,19,18,18,18,18,18,19,19,18,18,18,18,19,19,18,18,18,19,18,8
